NO textures/goat/moktar.xpm
SO textures/goat/grognon.xpm       
WE textures/goat/capri.xpm  
EA textures/goat/goat.xpm



F 150,90,145    
C 65,249,255

11111111111111111111111111111111111111111111                                    
1000000000000000000000000000000000000000S001
10000000000000000000000000000000000000000001                        
10000000000000000000000000000000000000000001
10000000000000000000000000000000000000000001
10000000000000000000000000000000000000000001
10000000000000000000000000000000000000000001
10000000000000000000000000000000000000000001
10000000000000000000000000000000000000000001
10000000000000000000000000000000000000000001
10000000000000000000000000000000000000000001
10000000000000000000000000000000000000000001
10000000000000000000000000000000000000000001
10000000000000000000000000000000000000000001
10000000000000000000000000000000000000000001
10000000000000000000000000000000000000000001
10000000000000000000000000000000000000000001
10000000000000000000000000000000000000000001
10000000000000000000000000000000000000000001
10000000000000000000000000000000000000000001
10000000000000000000000000000000000000000001
10000000000000000000000000000000000000000001
10000000000000000000000000000000000000000001
11111111111111111111111111111111111111111111
