NO textures/goat/moktar.xpm


            SO textures/goat/grognon.xpm
F 150,90,145 
WE textures/goat/capri.xpm
C 65,249,255
     EA textures/goat/goat.xpm


      
     111
    100011
     100011
    11000001
     100N01111111111
     10000001
      110010111111111111111
      111111