NO textures/north.xpm
SO textures/south.xpm

C 0,0,255








WE textures/west.xpm

F 0,255,0
EA textures/east.xpm



111111111
1000001
1000111
10000011
100S000011
10000000001
1111111111111