NO textures/north.xpm
SO textures/south.xpm

C 225,30,0

WE textures/west.xpm

F 220,100,0
EA textures/east.xpm



11111111
10000001
10000001
10000001
10000001
10000101
10000S01
10000001
11111111