NO textures/north.xpm
SO textures/south.xpm

C 0,0,255

WE textures/west.xpm

F 0,255,0
EA textures/east.xpm



11111111
1011111111111
1000000000001
100000011111
10000001
10000101
10000S01
10000001
11111111