NO textures/north.xpm
SO textures/south.xpm

C 0,0,255

WE textures/west.xpm

F 0,255,0
EA textures/east.xpm



11111111
10000001
10000001
10000001
10000001
10000101
10000S01
10000001
11111111