NO textures/goat/moktar.xpm


F 150,90,145 
C 65,249,255
SO textures/goat/grognon.xpm
WE textures/goat/capri.xpm
EA textures/goat/goat.xpm


      
     111
    100011
     100011
    1100011
      11N01
      10001
      110010
      11111