NO textures/north.xpm





SO textures/south.xpm









C 225,30,0

WE textures/west.xpm

F 220,100,0







EA textures/east.xpm



        1111111111111111111111111
        1000000000110000000000001
        10110000011100000000000010 1
        10010000000000000000010N01100
1111111110110000011100000000000011 1
100000000011000001110111111111111
11110111111111011100000010001
11110111111111011101010010001
1100000011010101110000001000001
10000000000000001100000010001
10000000000000001101010010001
1100000111010101111101111000111
11110111 1110101 101111010001
11111111 1111111 111111111111