NO textures/wolfenstein/bluestone.xpm
SO textures/wolfenstein/colorstone.xpm

C 255,0,0








WE textures/wolfenstein/mossy.xpm

F 0,255,0
EA textures/wolfenstein/redbrick.xpm


        1111111111111111111111111
        1000000000110000000000001
        10110000011100000000000010 1
        10010000000000000000010001100
1111111110110000011100000000000011 1
100000000011000001110111111111111
11110111111111011100000010001
11110111111111011101010010001      
11000000110101011100000000001
10000000000000001100000010001
10E00000000000001101010010001
1000000111010101111101111000101
10000111 1110101 101111010001
11111111 1111111 111111111111